Aachen	 Germany
Aalborg	 Denmark
Aba	 Nigeria
Abadan	 Iran
Abaetetuba	 Brazil
Abakan	 Russia
Abbotabad	 Pakistan
Abbotsford	 Canada
Abeokuta	 Nigeria
Aberdeen	 United Kingdom
Abidjan	 Ivory Coast
Abiko	 Japan
Abilene	 United States
Abohar	 India
Abu Dhabi	 United Arab Emirates
Abuja	 Nigeria
Acapulco	 Mexico
Acarigua	 Venezuela
Accra	 Ghana
Acheng	 China
Achinsk	 Russia
Adana	 Turkey
Adapazarı	 Turkey
Addis Ababa	 Ethiopia
Adelaide	 Australia
Aden	 Yemen
Adhamiyah	 Iraq
Adıyaman	 Turkey
Ado-Ekiti	 Nigeria
Adoni	 India
Afyon	 Turkey
Agadir	 Morocco
Agartala	 India
Ageo	 Japan
Agra	 India
Aguascalientes	 Mexico
Ahmedabad	 India
Ahmednagar	 India
Ahome	 Mexico
Ahuachapán	 El Salvador
Ahvaz	 Iran
Ain Beida	 Algeria
Aix-en-Provence	 France
Aizawl	 India
Aizuwakamatsu	 Japan
Ajmer	 India
Akashi	 Japan
Akesu	 China
Akishima	 Japan
Akita	 Japan
Akola	 India
Akron	 United States
Aksaray	 Turkey
Aktau	 Kazakhstan
Aktobe	 Kazakhstan
Al 'Arish	 Egypt
Al-Hasakah	 Syria
Al Minya	 Egypt
Alagoinhas	 Brazil
Al Ain	 United Arab Emirates
Alajuela	 Costa Rica
Alanya	 Turkey
Albacete	 Spain
Albuquerque	 United States
Albury-Wodonga	 Australia
Alcalá de Henares	 Spain
Alchevsk	 Ukraine
Alcorcón	 Spain
Aleppo	 Syria
Aletay	 China
Alexandra	 South Africa
Alexandria	 United States
Alexandria	 Egypt
Al-Fashir	 Sudan
Algeciras	 Spain
Algiers	 Algeria
Alicante	 Spain
Aligarh	 India
Alipurduar	 India
Allahabad	 India
Allappuzha	 India
Allentown	 United States
Almada	 Portugal
Almaty	 Kazakhstan
Almere	 Netherlands
Almería	 Spain
Almetyevsk	 Russia
Alor Setar	 Malaysia
Al Qadarif	 Sudan
Al-Ubayyid	 Sudan
Alvorada	 Brazil
Alwar	 India
Amadora	 Portugal
Amagasaki	 Japan
Amarah	 Iraq
Amarillo	 United States
Ambala	 India
Ambato	 Ecuador
Ambon	 Indonesia
Americana	 Brazil
Amersfoort	 Netherlands
Amiens	 France
Amman	 Jordan
Amol	 Iran
Amravati	 India
Amritsar	 India
Amroha	 India
Amsterdam	 Netherlands
Anaheim	 United States
Anand	 India
Ananindeua	 Brazil
Anápolis	 Brazil
Anchorage	 United States
Anda	 China
Andijan	 Uzbekistan
Andimeshk	 Iran
Andong	 South Korea
Angarsk	 Russia
Angeles City	 Philippines
Angers	 France
Angren	 Uzbekistan
Anjō	 Japan
Ankang	 China
Ankara	 Turkey
Anlu	 China
Ann Arbor	 United States
Annaba	 Algeria
Anqing	 China
Ansan	 South Korea
Anshan	 China
Anshun	 China
Antakya	 Turkey
Antalya	 Turkey
Antananarivo	 Madagascar
Antipolo City	 Philippines
Antofagasta	 Chile
Antwerp	 Belgium
Anyang	 China
Anyang	 South Korea
Aomori	 Japan
Aparecida de Goiânia	 Brazil
Apeldoorn	 Netherlands
Apopa	 El Salvador
Apucarana	 Brazil
Ar Raqqah	 Syria
Aracaju	 Brazil
Araçatuba	 Brazil
Arad	 Romania
Araguaína	 Brazil
Arak	 Iran
Arapiraca	 Brazil
Araraquara	 Brazil
Araras	 Brazil
Araure	 Venezuela
Arayat	 Philippines
Arcot	 India
Ardabil	 Iran
Arecibo	 Puerto Rico
Arequipa	 Peru
Argenteuil	 France
Arica	 Chile
Arkhangelsk	 Russia
Arlington, Texas	 United States
Arlington, Virginia	 United States
Armavir	 Russia
Armenia	 Colombia
Arnhem	 Netherlands
Arrah	 India
Arusha	 Tanzania
Arvada	 United States
Arzamas	 Russia
Asahikawa	 Japan
Asaka	 Japan
Asansol	 India
Arsenal	{ITA}
Ashdod	 Israel
Ashikaga	 Japan
Asmara	 Eritrea
Astana	 Kazakhstan
Astrakhan	 Russia
Asunción	 Paraguay
Aswan	 Egypt
Asyut	 Egypt
Aşgabat	 Turkmenistan
Athens	 Greece
Athens	 United States
Atibaia	 Brazil
Atlanta	 United States
Atsugi	 Japan
Atushi	 China
Atyrau	 Kazakhstan
Auckland	 New Zealand
Augsburg	 Germany
Augusta	 United States
Aurangabad	 India
Aurora, Colorado	 United States
Aurora, Illinois	 United States
Austin	 United States
Avellaneda	 Argentina
Avignon	 France
Ayacucho	 Peru
Aydın	 Turkey
Århus	 Denmark
Bab Ezzouar	 Algeria
Babol	 Iran
Babruysk	 Belarus
Bacău	 Romania
Bacolod	 Philippines
Bacoor	 Philippines
Badajoz	 Spain
Badalona	 Spain
Bafoussam	 Cameroon
Bagé	 Brazil
Baghdad	 Iraq
Bago City	 Philippines
Bago	 Burma
Baguio	 Philippines
Baharampur	 India
Bahawalnagar	 Pakistan
Bahawalpur	 Pakistan
Bahía Blanca	 Argentina
Bahir Dar	 Ethiopia
Bahraich	 India
Baia Mare	 Romania
Baicheng	 China
Baidoa	 Somalia
Baise	 China
Baishan	 China
Baiyin	 China
Bakersfield	 United States
Baku	 Azerbaijan
Balakovo	 Russia
Balashikha	 Russia
Baleshwar	 India
Balıkesir	 Turkey
Balikpapan	 Indonesia
Baliuag	 Philippines
Bally	 India
Bălți	 Moldova
Baltimore	 United States
Balurghat	 India
Bamako	 Mali
Bamenda	 Cameroon
Banda Aceh	 Indonesia
Bandar Abbas	 Iran
Bandırma	 Turkey
Bandung	 Indonesia
Bangalore	 India
Bangkok	 Thailand
Bangui	 Central African Republic
Banha	 Egypt
Bani Suwayf	 Egypt
Banja Luka	 Bosnia and Herzegovina
Banjarmasin	 Indonesia
Banjul	 Gambia
Bankura	 India
Baoding	 China
Baoji	 China
Baoshan	 China
Baotou	 China
Barakaldo	 Spain
Baraki	 Algeria
Baranagar	 India
Baranovichi	 Belarus
Barbacena	 Brazil
Barcelona	 Venezuela
Barcelona	 Spain
Bardhaman	 India
Bareilly	 India
Bari	 Italy
Barika	 Algeria
Barinas	 Venezuela
Barisal	 Bangladesh
Barnaul	 Russia
Barquisimeto	 Venezuela
Barra Mansa	 Brazil
Barrackpur	 India
Barrancabermeja	 Colombia
Barranquilla	 Colombia
Barreiras	 Brazil
Barretos	 Brazil
Barrie	 Canada
Barueri	 Brazil
Baruta	 Venezuela
Barysaw	 Belarus
Basel	  Switzerland
Basirhat	 India
Basra	 Iraq
Bat Yam	 Israel
Batala	 India
Batam	 Indonesia
Batangas City	 Philippines
Bataysk	 Russia
Bath	 United Kingdom
Bathinda	 India
Batman	 Turkey
Batna	 Algeria
Baton Rouge	 United States
Battambang	 Cambodia
Batumi	 Georgia
Bauru	 Brazil
Bayambang	 Philippines
Bayamo	 Cuba
Bayamón	 Puerto Rico
Bayannur	 China
Bayawan	 Philippines
Baybay	 Philippines
Bazhou	 China
Beau-Bassin	 Mauritius
Beaumont	 United States
Beauvais	 France
Beawar	 India
Béchar	 Algeria
Beed	 India
Beersheba	 Israel
Bei'an	 China
Beihai	 China
Beijing	 China
Beipiao	 China
Beirut	 Lebanon
Béjaïa	 Algeria
Belém	 Brazil
Belfast	 United Kingdom
Belford Roxo	 Brazil
Belgaum	 India
Belgorod	 Russia
Belgrade	 Serbia
Bellary	 India
Bellevue	 United States
Bello	 Colombia
Belo Horizonte	 Brazil
Bengbu	 China
Benghazi	 Libya
Benguela	 Angola
Beni Mellal	 Morocco
Benito Juárez	 Mexico
Benoni	 South Africa
Benxi	 China
Beppu	 Japan
Berbera	 Somalia
Berdyansk	 Ukraine
Berezniki	 Russia
Bergamo	 Italy
Bergen	 Norway
Bergisch Gladbach	 Germany
Berhampur	 India
Berkeley	 United States
Berlin	 Germany
Bern	  Switzerland
Besançon	 France
Betim	 Brazil
Bettiah	 India
Bhadravati	 India
Bhagalpur	 India
Bhalwal	 Pakistan
Bharatpur	 India
Bharatpur	   Nepal
Bharuch	 India
Bhatpara	 India
Bhavnagar	 India
Bhilai	 India
Bhilwara	 India
Bhimavaram	 India
Bhind	 India
Bhiwandi	 India
Bhiwani	 India
Bhopal	 India
Bhubaneswar	 India
Bhuj	 India
Bhusawal	 India
Białystok	 Poland
Bidar	 India
Bielefeld	 Germany
Bielsko-Biała	 Poland
Bihar Sharif	 India
Bijapur	 India
Bikaner	 India
Bila Tserkva	 Ukraine
Bilaspur	 India
Bilbao	 Spain
Billings	 United States
Biñan	 Philippines
Binangonan	 Philippines
Binzhou	 China
Biratnagar	   Nepal
Birjand	 Iran
Birmingham	 United Kingdom
Birmingham	 United States
Bishkek	 Kyrgyzstan
Bislig	 Philippines
Biskra	 Algeria
Bissau	 Guinea-Bissau
Biysk	 Russia
Bizerte	 Tunisia
Blackburn	 United Kingdom
Blackpool	 United Kingdom
Blagoveshchensk	 Russia
Blantyre	 Malawi
Blida	 Algeria
Bloemfontein	 South Africa
Blumenau	 Brazil
Bnei Brak	 Israel
Boa Vista	 Brazil
Bobo-Dioulasso	 Burkina Faso
Bocaue	 Philippines
Bochum	 Germany
Bogor	 Indonesia
Bogra	 Bangladesh
Boise	 United States
Bojnord	 Iran
Bokaro Steel City	 India
Boksburg	 South Africa
Bole	 China
Bologna	 Italy
Bolton	 United Kingdom
Boma	 Democratic Republic of the Congo
Bonn	 Germany
Bordeaux	 France
Bordj Bou Arréridj	 Algeria
Bordj El Kiffan	 Algeria
Borujerd	 Iran
Bosaso	 Somalia
Boston	 United States
Botoșani	 Romania
Botou	 China
Botshabelo	 South Africa
Bottrop	 Germany
Botucatu	 Brazil
Bou Saâda	 Algeria
Bouaké	 Ivory Coast
Boulder	 United States
Boulogne-Billancourt	 France
Bourg-en-Bresse	 France
Bournemouth	 United Kingdom
Bozhou	 China
Bradford	 United Kingdom
Braga	 Portugal
Bragança Paulista	 Brazil
Brăila	 Romania
Brampton	 Canada
Brasília	 Brazil
Brașov	 Romania
Bratislava	 Slovakia
Bratsk	 Russia
Braunschweig	 Germany
Brazzaville	 Republic of the Congo
Breda	 Netherlands
Bremen	 Germany
Bremerhaven	 Germany
Brescia	 Italy
Brest	 Belarus
Brest	 France
Bridgeport	 United States
Brighton	 United Kingdom
Brisbane	 Australia
Bristol	 United Kingdom
Brno	 Czech Republic
Brownsville	 United States
Bruges	 Belgium
Brussels	 Belgium
Bryansk	 Russia
Bucaramanga	 Colombia
Bucharest	 Romania
Bucheon	 South Korea
Budapest	 Hungary
Budaun	 India
Buenaventura	 Colombia
Buenos Aires	 Argentina
Buffalo	 United States
Buga	 Colombia
Bujumbura	 Burundi
Bukan	 Iran
Bukavu	 Democratic Republic of the Congo
Bukhara	 Uzbekistan
Bulandshahr	 India
Bulawayo	 Zimbabwe
Buôn Ma Thuột	 Vietnam
Burao	 Somalia
Burbank	 United States
Burewala	 Pakistan
Burgas	 Bulgaria
Burgos	 Spain
Burhanpur	 India
Burlington	 Canada
Burnaby	 Canada
Bursa	 Turkey
Bury	 United Kingdom
Busan	 South Korea
Bushehr	 Iran
Butuan	 Philippines
Buzău	 Romania
Bydgoszcz	 Poland
Bytom	 Poland
Cabanatuan City	 Philippines
Cabimas	 Venezuela
Cabo de Santo Agostinho	 Brazil
Cabo Frio	 Brazil
Cabuyao City	 Philippines
Cachoeirinha	 Brazil
Cachoeiro de Itapemirim	 Brazil
Cadiz City	 Philippines
Cádiz	 Spain
Caen	 France
Cagayan de Oro	 Philippines
Cagliari	 Italy
Caguas	 Puerto Rico
Cainta	 Philippines
Cairns	 Australia
Cairo	 Egypt
Cajamarca	 Peru
Calabar	 Nigeria
Calais	 France
Calama	 Chile
Calamba City	 Philippines
Calapan City	 Philippines
Calbayog	 Philippines
Calgary	 Canada
Cali	 Colombia
Caloocan	 Philippines
Camaçari	 Brazil
Camagüey	 Cuba
Camaragibe	 Brazil
Cambridge	 United States
Cambridge	 Canada
Cambridge	 United Kingdom
Campeche	 Mexico
Cẩm Phả	 Vietnam
Campina Grande	 Brazil
Campinas	 Brazil
Campo Grande	 Brazil
Campos dos Goytacazes	 Brazil
Canberra	 Australia
Candelaria	 Philippines
Cangzhou	 China
Canoas	 Brazil
Cần Thơ	 Vietnam
Cape Breton	 Canada
Cape Coral	 United States
Cape Town	 South Africa
Cap-Haïtien	 Haiti
Caracas	 Venezuela
Carapicuíba	 Brazil
Carcar	 Philippines
Cardiff	 United Kingdom
Cariacica	 Brazil
Carolina	 Puerto Rico
Carlisle	 United Kingdom
Carrefour	 Haiti
Carrollton	 United States
Cartagena de Indias	 Colombia
Cartagena	 Spain
Cartago	 Costa Rica
Cartago	 Colombia
Caruaru	 Brazil
Carúpano	 Venezuela
Casablanca	 Morocco
Cascavel	 Brazil
Castanhal	 Brazil
Castellón de la Plana	 Spain
Catanduva	 Brazil
Catania	 Italy
Catia La Mar	 Venezuela
Cauayan City	 Philippines
Caucaia	 Brazil
Cavite City	 Philippines
Caxias do Sul	 Brazil
Caxias	 Brazil
Cayenne	 French Guiana
Cebu City	 Philippines
Cedar Rapids	 United States
Celaya	 Mexico
Chandannagar	 India
Chandigarh	 India
Chandler	 United States
Chandrapur	 India
Changchun	 China
Changde	 China
Changji	 China
Changsha	 China
Changshi	 China
Changwon	 South Korea
Changzhi	 China
Changzhou	 China
Chaohu	 China
Chaoyang	 China
Chaozhou	 China
Chapecó	 Brazil
Chhapra	 India
Charikar	 Afghanistan
Charleroi	 Belgium
Charlotte	 United States
Chatham-Kent	 Canada
Chattanooga	 United States
Cheboksary	 Russia
Chelyabinsk	 Russia
Chemnitz	 Germany
Chengde	 China
Chengdu	 China
Chengzhou	 China
Chennai	 India
Cheonan	 South Korea
Cheongju	 South Korea
Cherepovets	 Russia
Cherkasy	 Ukraine
Cherkessk	 Russia
Chernihiv	 Ukraine
Chernivtsi	 Ukraine
Cherthala	 India
Chía	 Colombia
Chiang Mai	 Thailand
Chiayi	 Taiwan
Chiba	 Japan
Chibi City	 China
Chicago	 United States
Chiclayo	 Peru
Chifeng	 China
Chigasaki	 Japan
Chihuahua	 Mexico
Chikmagalur	 India
Chillán	 Chile
Chilpancingo	 Mexico
Chimalhuacán	 Mexico
Chimbote	 Peru
Chinandega	 Nicaragua
Chincha Alta	 Peru
Chingola	 Zambia
Chiniot	 Pakistan
Chirala	 India
Chirchiq	 Uzbekistan
Chishtian	 Pakistan
Chişinău	 Moldova
Chita	 Russia
Chitradurga	 India
Chittagong	 Bangladesh
Chittoor	 India
Chitungwiza	 Zimbabwe
Chizhou	 China
Chlef	 Algeria
Chōfu	 Japan
Choloma	 Honduras
Choluteca	 Honduras
Chonburi	 Thailand
Chongjin	 North Korea
Chongqing	 China
Chorzów	 Poland
Christchurch	 New Zealand
Chula Vista	 United States
Chuncheon	 South Korea
Chungju	 South Korea
Chuxiong City	 China
Chuzhou	 China
Cienfuegos	 Cuba
Cincinnati	 United States
Cirebon	 Indonesia
Ciudad Apodaca	 Mexico
Ciudad Bolívar	 Venezuela
Ciudad Acuña	 Mexico
Ciudad del Este	 Paraguay
Ciudad Delgado	 El Salvador
Ciudad Guayana	 Venezuela
Ciudad Juárez	 Mexico
Ciudad López Mateos	 Mexico
Ciudad Losada	 Venezuela
Ciudad Madero	 Mexico
Ciudad Nezahualcóyotl	 Mexico
Ciudad Obregón	 Mexico
Ciudad Victoria	 Mexico
Cixi	 China
Clarksville	 United States
Clearwater	 United States
Clermont-Ferrand	 France
Cleveland	 United States
Cluj-Napoca	 Romania
Coacalco	 Mexico
Coatzacoalcos	 Mexico
Cochabamba	 Bolivia
Codó	 Brazil
Coimbatore	 India
Coimbra	 Portugal
Colatina	 Brazil
Colchester	 United Kingdom
Colima	 Mexico
Cologne	 Germany
Colombo	 Brazil
Colombo	 Sri Lanka
Colón	 Panama
Colorado Springs	 United States
Columbia	 United States
Columbus, Georgia	 United States
Columbus, Ohio	 United States
Comilla	 Bangladesh
Comodoro Rivadavia	 Argentina
Conakry	 Guinea
Concepción	 Chile
Concord	 United States
Concordia	 Argentina
Constanţa	 Romania
Constantine	 Algeria
Contagem	 Brazil
Copenhagen	 Denmark
Copiapó	 Chile
Coquimbo	 Chile
Coquitlam	 Canada
Coral Springs	 United States
Corby	 England
Córdoba	 Argentina
Córdoba	 Spain
Córdoba	 Mexico
Cork	 Ireland
Çorlu	 Turkey
Coro	 Venezuela
Corona	 United States
Corpus Christi	 United States
Corrientes	 Argentina
Çorum	 Turkey
Costa Mesa	 United States
Cotabato City	 Philippines
Cotia	 Brazil
Cotonou	 Benin
Cottbus	 Germany
Coventry	 United Kingdom
Craiova	 Romania
Crato	 Brazil
Crawley	 United Kingdom
Criciúma	 Brazil
Cuautitlán	 Mexico
Cuautla	 Mexico
Cubatão	 Brazil
Cúcuta	 Colombia
Cuddalore	 India
Cuenca	 Ecuador
Cuernavaca	 Mexico
Cuiabá	 Brazil
Culiacán	 Mexico
Cumaná	 Venezuela
Curicó	 Chile
Curitiba	 Brazil
Cusco	 Peru
Cuttack	 India
Częstochowa	 Poland
Da Nang	 Vietnam
Dabgram	 India
Dąbrowa Górnicza	 Poland
Dadu	 Pakistan
Daegu	 South Korea
Daejeon	 South Korea
Dagupan	 Philippines
Daitō	 Japan
Dakar	 Senegal
Da Lat	 Vietnam
Dali	 China
Dalian	 China
Dallas	 United States
Daloa	 Ivory Coast
Daly City	 United States
Damanhur	 Egypt
Damascus	 Syria
Dammam	 Saudi Arabia
Damoh	 India
Danao City	 Philippines
Dandong	 China
Dangyang	 China
Danjiangkou	 China
Danyang	 China
Daqing	 China
Dar Es Salaam	 Tanzania
Daraga	 Philippines
Darbhanga	 India
Darlington	 United Kingdom
Darmstadt	 Germany
Darwin	 Australia
Daska	 Pakistan
Dasmariñas	 Philippines
Daşoguz	 Turkmenistan
Datong	 China
Daugavpils	 Latvia
Davangere	 India
Davao City	 Philippines
Dayton	 United States
Dazhou	 China
Debrecen	 Hungary
Dehiwala-Mount Lavinia	 Sri Lanka
Dehradun	 India
Deir ez Zor	 Syria
Delhi	 India
Delmas	 Haiti
Dengzhou	 China
Denizli	 Turkey
Denpasar	 Indonesia
Denver	 United States
Dera Ghazi Khan	 Pakistan
Derbent	 Russia
Derby	 United Kingdom
Derince	 Turkey
Des Moines	 United States
Dessie	 Ethiopia
Detroit	 United States
Dewas	 India
Deyang	 China
Dezful	 Iran
Dezhou	 China
Dhaka	 Bangladesh
Dhanbad	 India
Dhule	 India
Diadema	 Brazil
Diaobingshan	 China
Dibrugarh	 India
Digos City	 Philippines
Dijon	 France
Dili	 Timor-Leste
Dimitrovgrad	 Russia
Dinajpur	 Bangladesh
Dindigul	 India
Dingzhou	 China
Dipolog City	 Philippines
Dire Dawa	 Ethiopia
Divinópolis	 Brazil
Diwaniyah	 Iraq
Diyarbakır	 Turkey
Djelfa	 Algeria
Djibouti	 Djibouti
Dniprodzerzhinsk	 Ukraine
Dnipropetrovsk	 Ukraine
Doboj	 Bosnia and Herzegovina
Dobrich	 Bulgaria
Dodoma	 Tanzania
Doha	 Qatar
Donetsk	 Ukraine
Dongchuan	 China
Dongguan	 China
Dongtai	 China
Dongyang	 China
Dongying	 China
Dordrecht	 Netherlands
Dortmund	 Germany
Dos Quebradas	 Colombia
Douala	 Cameroon
Dourados	 Brazil
Downey	 United States
Dresden	 Germany
Drobeta-Turnu Severin	 Romania
Dubai	 United Arab Emirates
Dublin	 Ireland
Dudley	 United Kingdom
Duisburg	 Germany
Duitama	 Colombia
Dujiangyan	 China
Dumaguete City	 Philippines
Dundee	 United Kingdom
Dunedin	 New Zealand
Dunhua	 China
Dunhuang	 China
Dunkerque	 France
Duque de Caxias	 Brazil
Durango	 Mexico
Durban	 South Africa
Durg	 India
Durgapur	 India
Durham	 United States
Durrës	 Albania
Dushanbe	 Tajikistan
Duyun	 China
Düsseldorf	 Germany
Dzerzhinsk	 Russia
Eastbourne	 United Kingdom
Ebetsu	 Japan
Ebina	 Japan
Ecatepec	 Mexico
Ede	 Netherlands
Ede	 Nigeria
Edéa	 Cameroon
Edinburgh	 United Kingdom
Edirne	 Turkey
Edmonton	 Canada
Eilat	 Israel
Eindhoven	 Netherlands
Ekibastuz	 Kazakhstan
El Aaiún	 Western Sahara
El Alto	 Bolivia
El Eulma	 Algeria
El Jadida	 Morocco
El Khroub	 Algeria
El Monte	 United States
El Oued	 Algeria
El Paso	 United States
El Progreso	 Honduras
Elazığ	 Turkey
Elbląg	 Poland
Elche	 Spain
Eldoret	 Kenya
Elektrostal	 Russia
Elista	 Russia
Elizabeth	 United States
Elk Grove	 United States
El-Mahalla El-Kubra	 Egypt
Eluru	 India
Emeishan	 China
Emmen	 Netherlands
Engels	 Russia
English Bazar	 India
Enschede	 Netherlands
Ensenada	 Mexico
Enshi	 China
Enugu	 Nigeria
Envigado	 Colombia
Erbil	 Iraq
Erfurt	 Germany
Erie	 United States
Erlangen	 Germany
Erode	 India
Erzincan	 Turkey
Erzurum	 Turkey
Escondido	 United States
Esenler	 Turkey
Esfahan	 Iran
Eskişehir	 Turkey
Esmeraldas	 Ecuador
Espoo	 Finland
Essen	 Germany
Etawah	 India
Eugene	 United States
Eujeongbu	 South Korea
Evansville	 United States
Exeter	 United Kingdom
Ezhou	 China
Faisalabad	 Pakistan
Faizabad	 India
Faridabad	 India
Farrukhabad	 India
Fatehpur	 India
Fayetteville	 United States
Fayyum	 Egypt
Feira de Santana	 Brazil
Fengcheng	 China
Fenghua	 China
Fergana	 Uzbekistan
Ferrara	 Italy
Ferraz de Vasconcelos	 Brazil
Fes	 Morocco
Firozabad	 India
Flint	 United States
Florence	 Italy
Florencia	 Colombia
Florianópolis	 Brazil
Floridablanca	 Colombia
Focşani	 Romania
Foggia	 Italy
Fontana	 United States
Forlì	 Italy
Formosa	 Argentina
Fort Collins	 United States
Fort Lauderdale	 United States
Fort Wayne	 United States
Fort Worth	 United States
Fortaleza	 Brazil
Fort-de-France	 Martinique
Foshan	 China
Foz do Iguaçu	 Brazil
Franca	 Brazil
Francisco Morato	 Brazil
Francistown	 Botswana
Franco da Rocha	 Brazil
Frankfurt am Main	 Germany
Freetown	 Sierra Leone
Freiburg im Breisgau	 Germany
Fremont	 United States
Fresno	 United States
Fu'an	 China
Fuchu	 Japan
Fuenlabrada	 Spain
Fuji	 Japan
Fujieda	 Japan
Fujimi	 Japan
Fujin City	 China
Fujinomiya	 Japan
Fujisawa	 Japan
Fukuya	 Japan
Fukui	 Japan
Fukuoka	 Japan
Fukushima	 Japan
Fukuyama	 Japan
Fuling	 China
Fullerton	 United States
Funabashi	 Japan
Funchal	 Portugal
Fushun	 China
Fuxin	 China
Fuyang	 China
Fuzhou, Fujian	 China
Fuzhou, Jiangxi	 China
Fürth	 Germany
Gabès	 Tunisia
Gaborone	 Botswana
Gadag-Betgeri	 India
Galați	 Romania
Gandhidham	 India
Gandhinagar	 India
Ganganagar	 India
Gangneung	 South Korea
Gəncə	 Azerbaijan
Ganzhou	 China
Gaocheng	 China
Garanhuns	 Brazil
Garden Grove	 United States
Garland	 United States
Garoua	 Cameroon
Gary	 United States
Gateshead	 United Kingdom
Gatineau	 Canada
Gaya	 India
Gaza City	 Palestine
Gaziantep	 Turkey
Gdańsk	 Poland
Gdynia	 Poland
Gebze	 Turkey
Geelong	 Australia
Gejiu	 China
Geleen-Sittard	 Netherlands
Gelsenkirchen	 Germany
General Santos City	 Philippines
Geneva	  Switzerland
Genova	 Italy
George Town	 Malaysia
Georgetown	 Guyana
Gera	 Germany
Germiston	 South Africa
Getafe	 Spain
Ghardaïa	 Algeria
Ghaziabad	 India
Ghazni	 Afghanistan
Ghent	 Belgium
Gifu	 Japan
Gijón	 Spain
Gilbert	 United States
Gingoog City	 Philippines
Girardot	 Colombia
Giresun	 Turkey
Giza	 Egypt
Glasgow	 United Kingdom
Glazov	 Russia
Glendale, Arizona	 United States
Glendale, California	 United States
Gliwice	 Poland
Gloucester	 United Kingdom
Godhra	 India
Godoy Cruz	 Ecuador
Goiânia	 Brazil
Gojra	 India
Gold Coast	 Australia
Goma	 Democratic Republic of the Congo
Gómez Palacio	 Mexico
Gonbad-e Qabus	 Iran
Gondar	 Ethiopia
Gondiya	 India
Gongzhuling	 China
Gorakhpur	 India
Gorgan	 Iran
Gorzów Wielkopolski	 Poland
Gothenburg	 Sweden
Governador Valadares	 Brazil
Göttingen	 Germany
Granada	 Nicaragua
Granada	 Spain
Grand Prairie	 United States
Grand Rapids	 United States
Gravataí	 Brazil
Graz	 Austria
Green Bay	 United States
Greensboro	 United States
Grenoble	 France
Groningen	 Netherlands
Grozny	 Russia
Grudziądz	 Poland
Guadalajara	 Mexico
Guadalupe	 Mexico
Guanare	 Venezuela
Guanghan	 China
Guangshui	 China
Guangyuan	 China
Guangzhou	 China
Guantánamo	 Cuba
Guarapuava	 Brazil
Guaratinguetá	 Brazil
Guarenas	 Venezuela
Guarujá	 Brazil
Guarulhos	 Brazil
Guatemala City	 Guatemala
Guayaquil	 Ecuador
Guaymas	 Mexico
Guaynabo	 Puerto Rico
Gudivada	 India
Guédiawaye	 Senegal
Guelma	 Algeria
Guelph	 Canada
Guigang	 China
Guilin	 China
Guiyang	 China
Gujiao	 China
Gujranwala	 Pakistan
Gujrat City	 India
Gulbarga	 India
Gumi	 South Korea
Guna	 India
Guntakul	 India
Gunsan	 South Korea
Guntur	 India
Gurgaon	 India
Guri	 South Korea
Guruvayur	 India
Guwahati	 India
Gwalior	 India
Gwangju	 South Korea
Gweru	 Zimbabwe
Gyeongju	 South Korea
Győr	 Hungary
Gyumri	 Armenia
Ha Long	 Vietnam
Haarlem	 Netherlands
Habikino	 Japan
Habra	 India
Hachinohe	 Japan
Hachiōji	 Japan
Hadano	 Japan
Haeju	 North Korea
Hafizabad	 Pakistan
Hagen	 Germany
Haicheng	 China
Haifa	 Israel
Haikou	 China
Hailun	 China
Haining City	 China
Haiphong	 Vietnam
Hakodate	 Japan
Haldia	 India
Haldwani-cum-Kathgodam	 India
Halifax	 Canada
Halle	 Germany
Hama	 Syria
Hamadan	 Iran
Hamamatsu	 Japan
Hamburg	 Germany
Hamhung	 North Korea
Hami City	 China
Hamilton	 New Zealand
Hamilton	 Canada
Hamm	 Germany
Hanam	 South Korea
Hancheng	 China
Handa	 Japan
Handan	 China
Hangzhou	 China
Hanoi	 Vietnam
Hanover	 Germany
Hanzhong	 China
Haora	 India
Hapur	 India
Harare	 Zimbabwe
Harbin	 China
Hargeisa	 Somalia
Haridwar	 India
Hartford	 United States
Hassan	 India
Hathras	 India
Hat Yai	 Thailand
Havana	 Cuba
Hayward	 United States
Hebi	 China
Hebron	 Palestine
Hechi	 China
Heerlen-Kerkrade	 Netherlands
Hefei	 China
Hegang	 China
Heidelberg	 Germany
Heihe	 China
Heilbronn	 Germany
Helsingborg	 Sweden
Helsinki	 Finland
Henderson	 United States
Hengshui	 China
Hengyang	 China
Heraklion	 Greece
Herat	 Afghanistan
Hermosillo	 Mexico
Herne	 Germany
Heshan	 China
Hetian	 China
Heyuan	 China
Heze	 China
Hialeah	 United States
Higashihiroshima	 Japan
Higashikurume	 Japan
Higashimurayama	 Japan
Higashiosaka	 Japan
Hikone	 Japan
Hildesheim	 Germany
Hilla	 Iraq
Himamaylan City	 Philippines
Himeji	 Japan
Hindupur	 India
Hino	 Japan
Hirataka	 Japan
Hiratsuka	 Japan
Hirosaki	 Japan
Hiroshima	 Japan
Hisar	 India
Hitachi	 Japan
Hitachinaka	 Japan
Ho Chi Minh City	 Vietnam
Hobart	 Australia
Hofu	 Japan
Holguín	 Cuba
Holon	 Israel
Homs	 Syria
Homyel	 Belarus
Hong Kong	 Hong Kong
Honghu	 China
Honolulu	 United States
Horlivka	 Ukraine
Hortolândia	 Brazil
Hoshiarpur	 India
Hospet	 India
Hospitalet de Llobregat	 Spain
Houghly-Chinsura	 India
Houma	 China
Houston	 United States
Hoya	 Japan
Hrodna	 Belarus
Hsinchu	 Taiwan
Huadian	 China
Huaian	 China
Huaibei	 China
Huaihua	 China
Huainan	 China
Huaiyin	 China
Huambo	 Angola
Huancayo	 Peru
Huanghua	 China
Huangshan	 China
Huangshi	 China
Huangyan	 China
Huánuco	 Peru
Huaraz	 Peru
Huaying	 China
Hubli-Dharwad	 India
Hudaida	 Yemen
Huddersfield	 United Kingdom
Huế	 Vietnam
Huelva	 Spain
Huhehaote	 China
Huixian	 China
Huizhou	 China
Huludao	 China
Hulunbuir	 China
Hunchung	 China
Huntington Beach	 United States
Huntsville	 United States
Huozhou	 China
Huzhou	 China
Hyderabad	 India
Hyderabad	 Pakistan
Hyesan	 North Korea
Iaşi	 Romania
Ibadan	 Nigeria
Ibagué	 Colombia
Ibaraki	 Japan
Ibarra	 Ecuador
Ibirité	 Brazil
Ica	 Peru
Ichalakaranji	 India
Ichihara	 Japan
Ichikawa	 Japan
Ichinomiya	 Japan
Ife	 Nigeria
Iida	 Japan
Ikeda	 Japan
Ikere-Ekiti	 Nigeria
Ikoma	 Japan
Iksan	 South Korea
Ila	 Nigeria
Ilagan	 Philippines
Ilam	 Iran
Ilesa	 Nigeria
Ilhéus	 Brazil
Iligan	 Philippines
Iloilo City	 Philippines
Ilopango	 El Salvador
Ilorin	 Nigeria
Imabari	 Japan
Imbaba	 Egypt
Imperatriz	 Brazil
Imphal	 India
Inazawa	 Japan
Inchon	 South Korea
Indaiatuba	 Brazil
Independence	 United States
Indianapolis	 United States
Indore	 India
Inegöl	 Turkey
Inglewood	 United States
Ingolstadt	 Germany
Innsbruck	 Austria
Ipatinga	 Brazil
Ipoh	 Malaysia
Ipswich	 United Kingdom
Iquique	 Chile
Iquitos	 Peru
Irapuato	 Mexico
Irbid	 Jordan
Iriga	 Philippines
Irkutsk	 Russia
Iruma	 Japan
Irvine	 United States
Irving	 United States
Ise	 Japan
Isesaki	 Japan
Ishinomaki	 Japan
İskenderun	 Turkey
Islam Shahr	 Iran
Islamabad	 Pakistan
Ismaïlia	 Egypt
Isparta	 Turkey
İstanbul	 Turkey
Itaboraí	 Brazil
Itabuna	 Brazil
Itagüí	 Brazil
Itaituba	 Brazil
Itajaí	 Brazil
Itami	 Japan
Itapecerica da Serra	 Brazil
Itapetininga	 Brazil
Itapevi	 Brazil
Itaquaquecetuba	 Brazil
Itu	 Brazil
Ivano-Frankivsk	 Ukraine
Ivanovo	 Russia
Iwaki, Fukushima	 Japan
Iwakuni	 Japan
Iwatsuki	 Japan
Iwo	 Nigeria
Ixtapaluca	 Mexico
Izhevsk	 Russia
İzmir	 Turkey
İzmit	 Turkey
Izumi	 Japan
Jabalpur	 India
Jaboatao dos Guarapes	 Brazil
Jacareí	 Brazil
Jackson	 United States
Jacksonville	 United States
Jacobabad	 Pakistan
Jaén	 Spain
Jaffna	 Sri Lanka
Jaipur	 India
Jakarta	 Indonesia
Jalalabad	 Afghanistan
Jalandhar	 India
Jalgaon	 India
Jalpaiguri	 India
Jalna	 India
Jamalpur	 Bangladesh
Jambi	 Indonesia
Jamnagar	 India
Jamshedpur	 India
Jaraguá do Sul	 Brazil
Jaranwala	 Pakistan
Jastrzębie Zdrój	 Poland
Jaú	 Brazil
Jaunpur	 India
Jayapura	 Indonesia
Jeddah	 Saudi Arabia
Jena	 Germany
Jeongju	 South Korea
Jeonju	 South Korea
Jequié	 Brazil
Jerez de la Frontera	 Spain
Jersey City	 United States
Jerusalem	 Israel
Jessore	 Bangladesh
Jhang	 Pakistan
Jhansi	 India
Jhelum	 Pakistan
Jiagedaqi	 China
Jiamusi	 China
Ji'an	 China
Ji'an	 China
Jiangmen	 China
Jiangshan	 China
Jiangyin	 China
Jiangyou	 China
Jiaohe	 China
Jiaojiang	 China
Jiaozhou City	 China
Jiaozuo	 China
Jiaxing	 China
Jiayuguan	 China
Jieshou	 China
Jijel	 Algeria
Jimma	 Ethiopia
Jimo	 China
Jinan	 China
Jinchang	 China
Jincheng	 China
Jingdezhen	 China
Jingmen	 China
Jingzhou	 China
Jinhua	 China
Jining	 China
Jinshi City	 China
Jinzhong	 China
Jinzhou	 China
Jishou	 China
Jiujiang	 China
Jiuquan	 China
Jiutai	 China
Jiutepec	 Mexico
Jixi	 China
Jiyuan	 China
Jizzakh	 Uzbekistan
João Pessoa	 Brazil
Jodhpur	 India
Joetsu	 Japan
Johannesburg	 South Africa
Johor Bahru	 Malaysia
Joinville	 Brazil
Joliet	 United States
Jorhat	 India
Jönköping	 Sweden
Jos	 Nigeria
Juazeiro do Norte	 Brazil
Juazeiro	 Brazil
Juba	 South Sudan
Juiz de Fora	 Brazil
Juliaca	 Peru
Junagadh	 India
Jundiaí	 Brazil
Jyväskylä	 Finland
Kabankalan	 Philippines
Kabul	 Afghanistan
Kabwe	 Zambia
Kadhimiya	 Iraq
Kadoma	 Japan
Kaduna	 Nigeria
Kaesong	 North Korea
Kafr Dawar	 Egypt
Kagoshima	 Japan
Kahramanmaraş	 Turkey
Kaifeng	 China
Kaili	 China
Kairouan	 Tunisia
Kaiserslautern	 Germany
Kaiyuan	 China
Kaiyuan	 China
Kakamigahara	 Japan
Kakinada	 India
Kakogawa	 Japan
Kaliningrad	 Russia
Kalisz	 Poland
Kallithea	 Greece
Kaluga	 Russia
Kalyan	 India
Kamagaya	 Japan
Kamakura	 Japan
Kamarhati	 India
Kamensk-Uralsky	 Russia
Kamianets-Podilskyi	 Ukraine
Kamoke	 Pakistan
Kampala	 Uganda
Kampong Cham	 Cambodia
Kamptee	 India
Kamyshin	 Russia
Kananga	 Democratic Republic of the Congo
Kanazawa	 Japan
Kanchipuram	 India
Kanchrapara	 India
Kandahar	 Afghanistan
Kandy	 Sri Lanka
Kanggye	 Burma
Kanhangad	 India
Kannur	 India
Kano	 Nigeria
Kanpur	 India
Kansas City	 United States
Kansk	 Russia
Kaohsiung	 Taiwan
Kaolack	 Senegal
Karachi	 Pakistan
Karaganda	 Kazakhstan
Karaikkudi	 India
Karaj	 Iran
Karaman	 Turkey
Karamay	 China
Karbala	 Iraq
Karimnagar	 India
Kariya	 Japan
Karlsruhe	 Germany
Karnal	 India
Karur	 India
Karnataka	 India
Kashan	 Iran
Kashgar	 China
Kashihara	 Japan
Kashiwa	 Japan
Kassala	 Sudan
Kassel	 Germany
kasuga	 Japan
Kasugai	 Japan
Kasukabe	 Japan
Kasur	 Pakistan
Kathlehong	 South Africa
Kathmandu	   Nepal
Katihar	 India
Katowice	 Poland
Kaunas	 Lithuania
Kawachinagano	 Japan
Kawagoe	 Japan
Kawaguchi	 Japan
Kawanishi	 Japan
Kawasaki	 Japan
Kayseri	 Turkey
Kazan	 Russia
Kecskemét	 Hungary
Kediri	 Indonesia
Keelung	 Taiwan
Kelowna	 Canada
Kemerovo	 Russia
Kempton Park	 South Africa
Kenitra	 Morocco
Kerch	 Ukraine
Kerman	 Iran
Kermanshah	 Iran
Khabarovsk	 Russia
Khairpur	 Pakistan
Khammam	 India
Khandwa	 India
Khanewal	 Pakistan
Khanpur	 Pakistan
Kharagpur	 India
Kharkiv	 Ukraine
Khartoum	 Sudan
Khartoum North	 Sudan
Khasavyurt	 Russia
Khayelitsha	 South Africa
Khenchela	 Algeria
Kherson	 Ukraine
Khimki	 Russia
Khmelnytskyi	 Ukraine
Khomeini Shahr	 Iran
Khon Kaen	 Thailand
Khoramabad	 Iran
Khoramshahr	 Iran
Khouribga	 Morocco
Khoy	 Iran
Khulna	 Bangladesh
Kırıkkale	 Turkey
Kızıltepe	 Turkey
Kidapawan City	 Philippines
Kiel	 Germany
Kielce	 Poland
Kiev	 Ukraine
Kigali	 Rwanda
Kikwit	 Democratic Republic of the Congo
Kimberley	 South Africa
Kimhae	 South Korea
Kingston	 Jamaica
Kingston	 Canada
Kingston upon Hull	 United Kingdom
Kinshasa	 Democratic Republic of the Congo
Kirkuk	 Iraq
Kirovohrad	 Ukraine
Kiryu	 Japan
Kisangani	 Democratic Republic of the Congo
Kisarazu	 Japan
Kiselyovsk	 Russia
Kishiwada	 Japan
Kislovodsk	 Russia
Kismayo	 Somalia
Kisumu	 Kenya
Kitakyushu	 Japan
Kitami	 Japan
Kitchener	 Canada
Kitwe	 Zambia
Klaipėda	 Lithuania
Klang	 Malaysia
Knoxville	 United States
Kobe	 Japan
Koblenz	 Germany
Kochi	 India
Kōchi	 Japan
Kodaira	 Japan
Kofu	 Japan
Koganei	 Japan
Kohat	 Pakistan
Kokand	 Uzbekistan
Kokshetau	 Kazakhstan
Kokubunji	 Japan
Kolar	 India
Kolhapur	 India
Kolkata	 India
Kollam	 India
Kolomna	 Russia
Kolwezi	 Democratic Republic of the Congo
Komaki	 Japan
Komatsu	 Japan
Komsomolsk-on-Amur	 Russia
Konya	 Turkey
Korba	 India
Korhogo	 Ivory Coast
Koriyama	 Japan
Korla	 China
Korolyov	 Russia
Koronadal City	 Philippines
Koshigaya	 Japan
Košice	 Slovakia
Kostanay	 Kazakhstan
Kosti	 Sudan
Kostroma	 Russia
Koszalin	 Poland
Kota Bharu	 Malaysia
Kota Kinabalu	 Malaysia
Kota	 India
Kothagudem	 India
Kottayam	 India
Kovrov	 Russia
Kozhikode	 India
Kragujevac	 Serbia
Kraków	 Poland
Kraljevo	 Serbia
Kramatorsk	 Ukraine
Krasnodar	 Russia
Krasnoyarsk	 Russia
Krasnyi Luch	 Ukraine
Krefeld	 Germany
Kremenchuk	 Ukraine
Krishnagar	 India
Kruševac	 Serbia
Kryvyi Rih	 Ukraine
Kuala Lumpur	 Malaysia
Kuala Terengganu	 Malaysia
Kuantan	 Malaysia
Kuching	 Malaysia
Kumagaya	 Japan
Kumamoto	 Japan
Kumasi	 Ghana
Kumbakonam	 India
Kunduz	 Afghanistan
Kunming	 China
Kunshan	 China
Kuopio	 Finland
Kurashiki	 Japan
Kure	 Japan
Kurgan	 Russia
Kurnool	 India
Kursk	 Russia
Kurume	 Japan
Kusatsu	 Japan
Kushiro	 Japan
Kut	 Iraq
Kutaisi	 Georgia
Kuwait City	 Kuwait
Kuwana	 Japan
Kütahya	 Turkey
Kuytun	 China
Kwekwe	 Zimbabwe
Kyoto	 Japan
Kyzyl	 Russia
Kyzylorda	 Kazakhstan
La Ceiba	 Honduras
La Coruña	 Spain
Las Palmas de Gran Canaria	 Spain
La Paz	 Bolivia
La Paz	 Mexico
La Plata	 Argentina
La Rioja	 Argentina
La Serena	 Chile
La Victoria	 Venezuela
Lafayette	 United States
Lages	 Brazil
Laghouat	 Algeria
Lagos	 Nigeria
Lahore	 Pakistan
Lahti	 Finland
Laiwu	 China
Laiyang	 China
Laizhou	 China
Lakewood	 United States
Lalitpur	 India
Lancaster	 United States
Langfang	 China
Lansing	 United States
Lanús	 Argentina
Lanxi	 China
Lanzhou	 China
Laoag City	 Philippines
Laohekou	 China
Lapu-Lapu City	 Philippines
Laredo	 United States
Larissa	 Greece
Larkana	 Pakistan
Larnaca	 Cyprus
Las Vegas	 United States
Latakia	 Syria
Latina	 Italy
Latur	 India
Launceston	 Australia
Lauro de Freitas	 Brazil
Lausanne	  Switzerland
Laval	 Canada
Le Havre	 France
Le Mans	 France
Leeds	 United Kingdom
Leganés	 Spain
Legazpi City	 Philippines
Legnica	 Poland
Leicester	 United Kingdom
Leiden	 Netherlands
Leipzig	 Germany
Leiyang	 China
Leling	 China
Lengshuijiang	 China
Lengshuitan	 China
Leninsk-Kuznetsky	 Russia
Lens	 France
León	 Mexico
León	 Spain
León	 Nicaragua
Leshan	 China
Leskovac	 Serbia
Leverkusen	 Germany
Lexington	 United States
Lhasa	 China
Lianyuan	 China
Lianyungang	 China
Liaocheng	 China
Liaoyang	 China
Liaoyuan	 China
Libreville	 Gabon
Lichuan	 China
Lida	 Belarus
Liège	 Belgium
Ligao City	 Philippines
Likasi	 Democratic Republic of the Congo
Liling	 China
Lille	 France
Lilongwe	 Malawi
Lima	 Peru
Limassol	 Cyprus
Limeira	 Brazil
Limerick	 Ireland
Limoges	 France
Lincoln	 United States
Linfen	 China
Linhai	 China
Linhares	 Brazil
Linköping	 Sweden
Linqing	 China
Linxia	 China
Linyi	 China
Linz	 Austria
Lipa City	 Philippines
Lipetsk	 Russia
Lisbon	 Portugal
Lishui	 China
Little Rock	 United States
Liupanshui	 China
Liuzhou	 China
Liverpool	 United Kingdom
Livornia	 United States
Livorno	 Italy
Ljubljana	 Slovenia
Lleida	 Spain
Lobito	 Angola
Logroño	 Spain
Loja	 Ecuador
Lomas de Zamora	 Argentina
Lomé	 Togo
London	 United Kingdom
London	 Canada
Londrina	 Brazil
Long Beach	 United States
Longjing	 China
Longkou	 China
Longueuil	 Canada
Longxuyen	 Vietnam
Longyan	 China
Los Angeles	 United States
Los Ángeles	 Chile
Los Mochis	 Mexico
Los Teques	 Venezuela
Loudi	 China
Louisville	 United States
Lowell	 United States
Lu'an	 China
Luanda	 Angola
Luanshya	 Zambia
Lubbock	 United States
Lübeck	 Germany
Lublin	 Poland
Lubumbashi	 Democratic Republic of the Congo
Lucena City	 Philippines
Lucerne	  Switzerland
Lucknow	 India
Ludhiana	 India
Ludwigshafen am Rhein	 Germany
Luhansk	 Ukraine
Luján de Cuyo	 Argentina
Luohe	 China
Luoyang	 China
Lusaka	 Zambia
Luton	 United Kingdom
Lutsk	 Ukraine
Luxembourg	 Luxembourg
Luxor	 Egypt
Luzhou	 China
Luziânia	 Brazil
Lviv	 Ukraine
Lyon	 France
Lysychansk	 Ukraine
Lyubertsy	 Russia
Ma'anshan	 China
Maastricht	 Netherlands
Mabalacat	 Philippines
Macaé	 Brazil
Macapá	 Brazil
Macau	 Macau
Maceió	 Brazil
Machakos	 Kenya
Machala	 Ecuador
Macheng	 China
Machida	 Japan
Machilipatnam	 India
Madison	 United States
Madiun	 Indonesia
Madrid	 Spain
Madurai	 India
Maebashi	 Japan
Magadan	 Russia
Magangué	 Colombia
Magdeburg	 Germany
Magé	 Brazil
Magelang	 Indonesia
Magnitogorsk	 Russia
Mahabad	 Iran
Mahbubnagar	 India
Maicao	 Colombia
Maidstone	 United Kingdom
Maiduguri	 Nigeria
Mainz	 Germany
Makati	 Philippines
Makhachkala	 Russia
Makiivka	 Ukraine
Malabo	 Equatorial Guinea
Málaga	 Spain
Malang	 Indonesia
Malappuram	 India
Mehsana	 India
Nabadwip	
Naberezhnye Chelny	
Nadiad	
Naga City	
Nagano	
Nagaoka	
Nagareyama	
Nagasaki	
Nagercoil	
Nagoya	
Nagpur	
Naha	
Naihati	
Nairobi	
Najaf	
Najafabad	
Nakhodka	
Nakhon Pathom	
Nakhon Ratchasima	
Nakhon Sawan	
Nakhon Si Thammarat	
Nakuru	
Nalchik	
Namangan	
Namdinh	
Nampho	
Nampula	
Namur	
Nanchang	
Nanchong	
Nancy	
Nanded	
Nandyal	
Nangong	
Nanjing	
Nanning	
Nanping	
Nantes	
Nantong	
Nanyang	
Naperville, Illinois	
Napier-Hastings	
Naples	
Nara	
Narashino	
Narayanganj	
Nasariya	
Nashik	
Nashville-Davidson, Tennessee	
Nassau	
Nasugbu, Batangas	
Natal	
Naucalpan	
Navapolatsk	
Navoi	
Navotas City	
Navsari	
Nawabganj	
Nawabshah	
Nazareth	
Nazilli	
Nazran	
N'djamena	
Ndola	
Neftekamsk	
Nefteyugansk	
Neijiang	
Neiva	
Nellore	
Netanya	
Neuquén	
Neuss	
Nevinnomyssk	
New Bombay	
New Delhi	
New Haven, Connecticut	
NOIDA	
New Orleans, Louisiana	
New York, New York	
Newark, New Jersey	
Newcastle upon Tyne	
Newcastle, South Africa	 South Africa
Newcastle	
Newport	
Neyagawa	
Neyshabur	
Neyveli	
Nhatrang	
Niamey	
Nice	
Nicosia	
Niigata	
Niihama	
Niiza	
Nijmegen	
Nikopol	
Nilópolis	
Nîmes	
Ningbo	
Ningde	
Niš	
Nishinomiya	
Nishio	
Niterói	
Nizamabad	
Nizhenvartovsk	
Nizhnekamsk	
Nizhny Novgorod	
Nizhny Tagil	
Nobeoka	
Noda	
Nogales	
Noginsk	
Nonthaburi	
Norilsk	
Norman, Oklahoma	
Norrköping	
North Las Vegas, Nevada	
Northampton	
Norwalk, California	
Norwich	
Norzagaray, Bulacan	
Nossa Senhora do Socorro	
Nottingham	
Nouakchott	
Nova Friburgo	
Nova Iguaçu	
Novara	
Novi Sad	
Nôvo Hamburgo	
Novocheboksarsk	
Novocherkassk	
Novokuybyshevsk	
Novokuznetsk	
Novomoskovsk	
Novorossiysk	
Novoshakhtinsk	
Novosibirsk	
Novotroitsk	
Novy Urengoy	
Noyabrsk	
Nueva San Salvador	
Nuevo Laredo	
Nukuʻalofa	
Nukus	
Numazu	
Nuremberg	
Nyala, Sudan	
Nyíregyháza	
Oakland, California	
Oakville	
Oaxaca de Juárez	
Oberhausen	
Obihiro	
Obninsk	
Oceanside, California	
Odawara	
Odense	
Odessa	
Odintsovo	
Offenbach am Main	
Ōgaki	
Ogbomosho	
Ōita	
Okara	
Okayama	
Okazaki	
Okinawa	
Oklahoma City, Oklahoma	
Oktyabrsky	
Oldenburg	
Oldham	
Olinda	
Olmaliq	
Olomouc	
Olongapo City	
Olsztyn	
Omaha, Nebraska	
Omdurman	
Omsk	
Ōmuta	
Ondal	
Ongole	
Onitsha	
Ontario, California	
Opole	
Or Yehuda	
Oradea	
Oral	
Oran	
Orange, California	
Ordos City	
Ordu	
Örebro	
Orekhovo-Zuyevo	
Orenburg	
Orizaba	
Orlando, Florida	
Orléans	
Ormoc City	
Orsha	
Orsk	
Orumiyeh	
Oruro	
Oryol	
Osaka	
Osasco	
Osh	
Oshawa	
Oshogbo	
Osijek	
Oslo	
Osmaniye	
Osnabrück	
Osorno	
Ostrava	
Ota	
Otaru	
Otsu	
Ottawa	
Ouagadougou	
Ouargla	
Oujda	
Oulu	
Ourense	
Overland Park, Kansas	
Oviedo	
Oxford	
Oxnard, California	
Oyama	
Oyo	
Ozamiz City	
Paarl	 South Africa
Pabna	
Pachuca	
Padang	
Paderborn	
Padua	
Pagadian City	
Pago Pago	
Paita	
Pakalongan	
Pakan Baru	
Pakpattan	
Palakkad	
Palangkaraya	
Palembang	
Palermo	
Pali	
Palma de Mallorca	
Palmas	
Palmdale, California	
Palmira	
Palu	
Pamplona	
Panabo City	
Panama City	
Pančevo	
Panevėžys	
Panihati	
Panipat	
Panjin	
Panzhihua	
Papeete	
Paradise, Nevada	
Parakou	
Paramaribo	
Paraná	
Paranaguá	
Parang, Maguindanao	
Parbhani	
Pardubice	
Paris	
Parla	
Pasadena	
Patos de Minas	
Patna	
Patras	
Patratu	
Paulista	
Pavlodar	
Pavlohrad	
Pécs	
Pelotas	
Pematang Siantar	
Pembroke Pines, Florida	
Penza	
Peoria, Arizona	
Peoria, Illinois	
Pereira	
Peristeri	
Perm	
Perpignan	
Perth	
Perugia	
Pervouralsk	
Pescara	
Peshawar	
Petah Tikva	
Petaling Jaya	
Petare	
Peterborough	
Petrolina	
Petropavl	
Petropavlovsk-Kamchatsky	
Petrópolis	
Petrozavodsk	
Pforzheim	
Philadelphia, Pennsylvania	
Phuket	
Phnom Penh	
Phoenix, Arizona	
Phusro	
Phyongsong	
Piatra Neamţ	
Pietermaritzburg	
Pikine	
Pilibhit	
Pinar del Río	
Pindamonhangaba	
Pingdingshan	
Pingdu	
Pingliang	
Pingxiang	
Pinhais	
Pinsk	
Piracicaba	
Piraeus	
Pir Mahal	
Piteşti	
Pittsburgh, Pennsylvania	
Piura	
Plano, Texas	
Pleven	
Płock	
Ploieşti	
Plovdiv	
Plymouth	
Plzeň	
Poços de Caldas	
Podgorica	
Podolsk	
Pohang	
Pointe-Noire	
Pollachi	
Polomolok, South Cotabato	
Poltava	
Pomona, California	
Ponce	
Pondicherry	
Ponta Grossa	
Pontianak	
Poole	
Popayán	
Porac, Pampanga	
Porbandar	
Port Elizabeth	
Port Harcourt	
Port Louis	
Port Moresby	
Port Said	
Port Sudan	
Port-au-Prince	
Portland, Oregon	
Porto Alegre	
Porto Novo	
Porto Velho	
Porto	
Portoviejo	
Portsmouth	
Posadas	
Potosí	
Potsdam	
Pouso Alegre	
Poza Rica de Hidalgo	
Poznań	
Prague	
Praia Grande	
Praia	
Prato	
Presidente Prudente	
Preston	
Pretoria	
Prijedor	
Priština	
Probolinggo	
Proddatur	
Prokopyevsk	
Providence, Rhode Island	
Provo, Utah	
Pskov	
Pucallpa	
Puebla de Zaragoza	
Pueblo, Colorado	
Puente Alto	
Puerto Cabello	
Puerto Montt	
Puerto Princesa City	
Puli Khumri	
Pune	
Puno	
Punta Arenas	
Punto Fijo	
Puri	
Purnia	
Putian	
Puyang	
Pyatigorsk	
Pyongyang	
Qa'em Shahr	
Qamishli	
Qarchak	
Qazvin	
Qianjiang	
Qidong	
Qingdao	
Qingtongxia	
Qingyang	
Qingyuan	
Qingzhou	
Qinhuangdao	
Qinyang	
Qinzhou	
Qiqihaer	
Qitaihe	
Qom	
Quanzhou	
Quebec City	
Queimados	
Querétaro	
Quetta	
Quevedo	
Quezon City	
Qufu	
Qui Nhon	
Quilmes	
Quilpué	
Quito	
Qujing	
Quzhou	
Rabat	 Morocco
Rach Gia	 Vietnam
Radom	 Poland
Rae Bareli	
Rahim Yar Khan	
Raichur	
Raiganj	
Raipur	
Rajahmundry	
Rajapalaiyam	
Rajkot	
Rajnandgaon	
Rajshahi	
Raleigh, North Carolina	
Ramadi	
Ramagundam	
Ramat Gan	
Râmnicu Vâlcea	
Rampur	
Ranaghat	
Rancagua	
Ranchi	
Rancho Cucamonga, California	
Rangpur	
Raniganj	
Rasht	
Ratlam	
Raurkela	
Ravenna	
Rawalpindi	
Rayong	
Reading	
Recife	
Recklinghausen	
Regensburg	
Reggio Calabria	
Regina	
Rehovot	
Reims	
Relizane	
Remscheid	
Rennes	
Reno, Nevada	
Renqiu	
Resende	
Resistencia	
Reutlingen	
Rewa	
Reykjavík	
Reynosa	
Ribeirão das Neves	
Ribeirão Pires	
Ribeirão Preto	
Richmond Hill	
Richmond	
Richmond, Virginia	
Riga	
Rijeka	
Rimini	
Rio Branco	
Rio Claro	
Rio Cuarto	
Rio de Janeiro	
Rio Grande	
Rio Verde	
Riobamba	
Rishon LeZion	
Riverside, California	
Rivne	
Riyadh	
Rizhao	
Rochester, Minnesota	
Rochester, New York	
Rockford, Illinois	
Rodriguez (Montalban), Rizal	
Rohtak	
Rome	
Rondonópolis	
Rongcheng	
Roodepoort	
Rosario	
Rostock	
Rostov-on-Don	
Rotherham	
Rotterdam	
Rouen	
Rousse	
Roxas City	
Rubtsovsk	
Ruda Śląska	
Rudni	
Ruian	
Ruichang	
Russiefa	
Rustavi	
Ruzhou	
Ryazan	
Rybinsk	 Russia
Rybnik	 Poland
Rzeszów	 Poland
Saanich	
Saarbrücken	
Sabadell	
Sabára	
Sabzewar	
Sacramento, California	
Sadiqabad	
Safi	
Saga	
Sagamihara	
Sagar	
Sagay City	
Saguenay	
Saharanpur	
Sahiwal	
Saida	
Saidpur	
Saint Petersburg	
Saint-Denis	
Saint-Étienne	
Saint John	
Saint Louis	
Saint-Paul	
Saitama	
Sakai, Osaka	
Sakata	
Sakura, Chiba	
Salamanca	
Salamanca	
Salavat	
Salé	
Salem, Oregon	
Salem	
Salerno	
Salihorsk	
Salinas, California	
Salt Lake City, Utah	
Salta	
Saltillo	
Salvador	
Salzburg	
Salzgitter	
Samara	
Samarinda	
Samarkand	
Sambalpur	
Sambhal	
Samsun	
San Antonio, Texas	
San Bernardino, California	
San Bernardo	
San Buenaventura, California	
San Carlos City, Negros Occidental	
San Carlos City, Pangasinan	
San Cristóbal	
San Cristóbal de Las Casas	
San Diego, California	
San Fernando City, La Union	
San Fernando City, Pampanga	
San Fernando del Valle de Catamarca	
San Francisco, California	
San José	
San Jose City, Nueva Ecija	
San Jose del Monte City	
San Jose, California	
San Jose, Occidental Mindoro	
San Juan, Argentina	
San Juan, Puerto Rico	
San Juan City, Metro Manila	
San Lorenzo	
San Luis Potosí	
San Luis	
San Martin	
San Mateo, Rizal	
San Miguel	
San Miguel de Tucumán	
San Miguel, Bulacan	
San Miguelito	
San Nicolás	
San Nicolás de los Garzas	
San Pablo City	
San Pedro de Macoris	
San Pedro Sula	
San Pedro, Laguna	
San Rafael	
San Salvador de Jujuy	
San Salvador	
San Sebastián	
Sana'a	
Sanandaj	
Sancti Spíritus	
Sanda	
Sandakan	
Sangli	
Şanlıurfa	
Sanmenxia	
Sanming	
Santa Ana, California	
Santa Bárbara d'Oeste	
Santa Clara, California	
Santa Clara	
Santa Clarita, California	
Santa Coloma de Gramanet	
Santa Cruz de la Sierra	
Santa Cruz de Tenerife	
Santa Cruz do Sul	
Santa Cruz, Laguna	
Santa Fe de Bogotá	
Santa Fe	
Santa Luzia, Minas Gerais	
Santa Maria, California	
Santa Maria, Bulacan	
Santa Marta	
Santa Rita	
Santa Rosa, California	
Santa Rosa City	
Santander	
Santarém, Brazil	
Santiago	
Santiago City	
Santiago de Cuba	
Santiago de los Caballeros	
Santiago del Estero	
Santipur	
Santo André	
Santo Domingo de los Colorados	
Santo Domingo	
Santo Tomas, Batangas	
Santos	
Sanya	
São Bernardo do Campo	
São Caetano do Sul	
São Carlos	
São Gonçalo	
São João de Meriti	
São José de Ribamar	
São José do Rio Preto	
São José dos Campos	
São José dos Pinhais	
São José	
São Leopoldo	
São Luís	
São Paulo	
São Vicente	
Sapporo	
Sapucaia do Sul	
Saqez	
Saraburi	
Sarajevo	
Saransk	
Sarapul	
Saratov	
Sar-e Pol	
Sargodha	
Sari	
Sariaya, Quezon	
Sariwon	
Sasebo	
Saskatoon	
Sassari	
Satna	
Satu Mare	
Savannah, Georgia	
Sayama	
Schwerin	
Scottsdale, Arizona	
Seam Reab	
Seattle	
Sabha	
Sekondi-Takoradi	
Seleyang Baru	
Semarang	
Semipalatinsk	
Sendai	
Seongnam	
Seoul	
Serampore	
Seremban	
Sergiyev Posad	
Serpukhov	
Serra	
Sertaozinho	
Sete Lagoas	
Setif	
Seto	
Sevastopol	
Severodvinsk	
Seversk	
Seville	
Sfax	
Shah Alam	
Shahe	
Shahjahanpur	
Qods	
Shahrekord	
Shahrud	
Shakhty	
Shanghai	
Shangluo	
Shangqiu	
Shangrao	
Shangzhi	
Shantou	
Shanwei	
Shaoguan	
Shaowu	
Shaoxing	
Shaoyang	
Sharjah	
Shchyolkovo	
Sheberghan	
Sheffield	
Sheikhu Pura	
Sheopur	
Shenyang	
Shenzhen	
Sherbrooke	
Shibin el-Kom	
Shihezi	
Shihung	
Shijiazhuang	
Shikarpur	
Shillong	
Shimizu	
Shymkent	
Shimla	
Shimoga	
Shimonoseki	
Shinyanga	
Shiraz	
Shishi City	
Shishou	
Shivpuri	
Shiyan	
Shizuishan	
Shizuoka	
Shkodër	
Shreveport, Louisiana	
Shuangcheng	
Shuangyashan	
Shubra al Khaymah	
Shuozhou	
Sialkote	
Šiauliai	
Sibiu	
Sibu	
Sidi-bel-Abbès	
Siegen	
Sieverodonetsk	
Siirt	
Sikar	
Silang, Cavite	
Silay City	
Silchar	
Siliguri	
Simferopol	
Simi Valley, California	
Sincelejo	
Singapore	
Sinuiji	
Sioux Falls, South Dakota	
Siping	
Sirjan	
Sirsa	
Sitapur	
Sittwe	
Sivakasi	
Sivas	
Siverek	
Skikda	
Skopje	
Sliven	
Slough	
Sloviansk	
Słupsk	
Smederevo	
Smolensk	
Soacha	
Sobral	
Sochi	
Sofia	
Sogamoso	
Soka	
Solapur	
Soledad	
Solihull	
Solikamsk	
Solingen	
Songkhla	
Songyuan	
Sonipat	
Sorocaba	
Sorsogon City	
Sosnowiec	
Souk Ahras	
South Bend, Indiana	
South Dum Dum	
Southampton	
Southend on Sea	
Soweto	
Soyapango	
Split	
Spokane, Washington	
Springfield, Illinois	
Springfield, Massachusetts	
Springfield, Missouri	
Springs	
Srinagar	
St Helens	
St Louis, Missouri	
St Paul, Minnesota	
St Petersburg, Florida	
St. Catharines	
St. John's	
Stakhanov	
Stamford, Connecticut	
Stara Zagora	
Starsy Oskol	
Stavanger	
Stavropol	
Sterling Heights, Michigan	
Sterlitamak	
Stockholm	
Stockport	
Stockton, California	
Stoke-on-Trent	
Strasbourg	
Stuttgart	
Subotica	
Suceava	
Sucre	
Suez	
Suhaj	
Suihua	
Suining	
Suita	
Suizhou	
Sukabumi	
Sukkur	
Sulamaniya	
Sullana	
Sultanbeyli	
Sultan Kudarat, Maguindanao	
Sumaré	
Sumgait	
Sumy	
Suncheon, South Korea	
Sunderland	
Sundsvall	
Sungai Petani	
Sunnyvale, California	
Sunshine Coast	
Suqian	
Surabaya	
Surakarta	
Surat Thani	
Surat	
Surgut	
Surigao City	
Surrey	
Suzano	
Sutton Coldfield	
Suva, Fiji	
Suwon, Puwan	
Suzhou, Anhui	
Suzhou, Jiangsu	
Suzuka	
Swansea	
Swindon	
Sydney	
Syktyvkar	
Syracuse	
Syracuse, New York	
Syzran	
Szczecin	
Szeged	
Székesfehérvár	
Ta’if	Saudi Arabia
Tabaco City	
Taboão da Serra	
Tabriz	
Tacheng	
Tachikawa	
Tacloban City	
Tacna	
Tacoma, Washington	
Taebaek	
Taganrog	
Taguig City	
Tagum City	
Taian	
Taichung	
Tainan City	
Taipei	
Taiping	
Taiyuan	
Taiz	
Taizhou, Jiangsu	
Taizhou, Zhejiang	
Tajimi	
Takamatsu	
Takaoka	
Takarazuka	
Takasaki	
Takatsuki	
Talara	
Talavera, Nueva Ecija	
Talca	
Talcahuano	
Talisay City, Cebu	
Tallahassee, Florida	
Tallinn	
Taloqan	
Tama	
Tamale	
Tambov	
Tampa, Florida	
Tampere	
Tampico	
Tanauan City	
Tandil	
Tandoadam	
Tanga	
Tangail	
Tangier	
Tangshan	
Tanjung Pinang	
Tanta	
Tanza, Cavite	
Taonan	
Tapachula	
Taranto	
Tarapoto	
Taraz	
Târgu-Mureş	
Tarija	
Tarlac City	
Tarnów	
Tarragona	
Tarsus	
Tartu	
Tashkent	
Taubaté	
Taunggyi	
Tauranga	
Taytay, Rizal	
Tbilisi	
Tebessa	
Tegal	
Tegucigalpa	
Tehran	
Tehuacán	
Teixeira de Freitas	
Tekirdağ	
Tel Aviv	
Telford	
Tembisa	
Temirtau	
Tempe, Arizona	
Temuco	
Tenali	
Tengzhou	
Teófilo Otoni	
Tepic	
Teresina	
Teresópolis	
Termez	
Terni	
Ternopil	
Terrassa	
Tétouan	
Thai Nguyen	
Thalassery	
Thane	
Thanjavur	
The Hague	
Thessaloniki	
Thiès	
Thimphu	
Thiruvananthapuram	
Thousand Oaks, California	
Thrissur	
Thunder Bay	
Tianjin	
Tianmen	
Tianshui	
Tiaret	
Tieli	
Tieling	
Tijuana	
Tilburg	
Timişoara	
Timon	
Tirana	
Tiruchchirappalli	
Tirunelveli	
Tirupati	
Tiruppur	
Tiruvannamalai	
Titagarh	
Tlalnepantla	
Tlalpan	
Tlaquepaque	
Tlaxcala	
Tlemoen	
Tobolsk	
Toda	
Tokat	
Tokorozawa	
Tokushima	
Tokuyama	
Tokyo	
Toledo City, Cebu	
Toledo, Ohio	
Toledo, Paraná	
Toluca	
Tolyatti	
Tomakomai	
Tomsk	
Tondabayashi	
Tongchuan	
Tonghua	
Tongi	
Tongjiang	
Tongliao	
Tongling	
Tongren	
Tonk	
Toowoomba	
Topeka, Kansas	
Toronto	
Torrance, California	
Torreón	
Toruń	
Tottori	
Touggourt	
Toulon	
Toulouse	
Tours	
Townsville	
Toyama	
Toyohashi	
Toyokawa	
Toyonaka	
Toyota	
Trabzon	
Trento	
Trieste	
Tripoli, Lebanon	
Tripoli, Libya	
Trois-Rivières	
Trondheim	
Trujillo	
Tsu	
Tsuchiura	
Tsukuba	
Tsuruoka	
Tucson, Arizona	
Tuguegarao City	
Tula	
Tulsa, Oklahoma	
Tulua	
Tulufan	
Tumbes	
Tumen	
Tumkur	
Tunis	
Tunja	
Turgutlu	
Turhal	
Turin	
Turkmenabat	
Turku	
Turmero	
Tuticorin	
Tuxtla Gutiérrez	
Tuzla	
Tver	
Tychy	
Tyumen	
Ube	
Uberaba	
Uberlândia	
Ubon Ratchathani	
Udaipur	
Udon Thani	
Udupi	
Ueda	
Ufa	
Uji	
Ujjain	
Ujung Pandang	
Ukhta	
Ulaan Chab	
Ulaanbaatar	
Ulan-Ude	
Ulhasnagar	
Ulm	
Ulsan	
Ulyanovsk	
Umeå	
Umlazi	
Unnao	
Uppsala	
Urasoe	
Urawa	
Urayasu	
Urdaneta City	
Urgentch	
Uruapan	
Uruguaiana	
Uşak	
Usolye-Sibirskoye	
Ussuriysk	
Ust-Ilimsk	
Ust-Kamenogorsk	
Utrecht	
Utsunomiya	
Uzhhorod	
Vadakara	
Vadodara	
Vaduz	
Valdivia	
Valencia City, Bukidnon	
Valencia	
Valencia, Venezuela	
Valenciennes	
Valera	
Valladolid	
Valle de Chalco	
Valledupar	
Vallejo, California	
Valparai	
Valparaíso	
Valsad	
Van	
Vanadzor	
Vancouver, Washington	
Vancouver	
Vantaa	
Varamin	
Varanasi	
Varginha	
Varna	
Varzea Grande	
Västerås	
Vaughan	
Velikiye Luki	
Veliky Novgorod	
Vellore	
Venice	
Veracruz	
Vereeniging	
Verona	
Viamão	
Vicente López, Buenos Aires	
Vicenza	
Las Tunas	
Victoria	
Vienna	
Vientiane	
Vigo	
Vijayawada	
Vila Nova de Gaia	
Vila Velha	
Villa Nicolás Romero	
Villahermosa	
Villavicencio	
Villeurbanne	
Vilnius	
Viña del Mar	
Vinh	
Vinnytsia	
Viranşehir	
Visakhapatnam	
Vitebsk	
Vitória da Conquista	
Vitória de Santo Antão	
Vitória	
Vitoria-Gasteiz	
Vizianagarm	
Vladikavkaz	
Vladimir	
Vladivostok	
Volgodonsk	
Volgograd	
Vologda	
Volos	
Volta Redonda	
Volzhsky	
Voronezh	
Votkinsk	
Vungtau	
Waco, Texas	 United States
Wad Madani	
Wadhwan	
Wafangdian	
Wah Cantonment	
Wakayama	
Wałbrzych	
Walsall	
Wanxian	
Warangal	
Wardha	
Warren, Michigan	
Warrington	
Warsaw	
Washington, D.C.	 United States
Waterbury, Connecticut	 United States
Watford	
Weifang	
Weihai	
Weihui	
Weinan	
Wellington	
Wendeng	
Wenzhou	
West Bromwich	
West Covina, California	 United States
West Valley City, Utah	 United States
Westminster, Colorado	 United States
Whitby	
Wichita Falls, Texas	
Wichita, Kansas	 United States
Wiesbaden	
Willemstad	
Windhoek	
Windsor	
Winnipeg	
Winston-Salem, North Carolina	 United States
Winterthur	
Witten	
Włocławek	
Wolfsburg	
Greater Wollongong	
Wolverhampton	
Wonju	
Wonsan	
Worcester, Massachusetts	 United States
Wrocław	
Wu'an	
Wuhai	
Wuhan	
Wuhu	
Wulanhaote	
Wulumuqi	
Wuppertal	
Wuwei	
Wuxi	
Wuxue	
Wuyishan	
Wuzhong	
Wuzhou	
Würzburg	
Xalapa	
Xiamen	
Xian	
Xiangfan	
Xiangtan	
Xianning	
Xiantao	
Xianyang	
Xiaogan	
Xiaoshan	
Xichang	
Xilinhaote	
Xingcheng	
Xinghua	
Xingtai	
Xingyi	
Xining	
Xinji	
Xintai	
Xinxiang	
Xinyang	
Xinyi	
Xinyu	
Xinzhou	
Xochimilco	
Xuancheng	
Xuchang	
Yachiyo	 Japan
Yaizu	 Japan
Yakeshi	
Yakutsk	
Yamagata	
Yamaguchi	
Yamato, Kanagawa	
Yamoussoukro	
Yamunanagar	
Yan'an	
Yancheng	
Yangjiang	
Yangon (Rangoon)	
Yangquan	
Yangzhou	
Yanji	
Yantai	
Yao	
Yaoundé	
Yaroslavl	
Yatsushiro	
Yavatmal	
Yazd	
Yekaterinburg	
Yelets	
Yenakiieve	
Yerevan	
Yibin	
Yichang	
Yichun, Heilongjiang	
Yichun, Jiangxi	
Yidu	
Yima	
Yinchuan	
Yingcheng	
Yingkou	
Yingtan	
Yining	
Yiwu	
Yixing	
Yiyang	
Yizheng	
Yogyakarta	
Yokkaichi	
Yokohama	
Yokosuka	
Yonago	
Yongan	
Yongzhou	
Yonkers, New York	
York	
Yoshkar-Ola	
Yosu	
Yuanjiang	
Yueyang	
Yulin, Guangxi	
Yulin, Shaanxi	
Yuma, Arizona	
Yumen	
Yuncheng, Shanxi	
Yuxi	
Yuyao	
Yuzhno-Sakhalinsk	
Yuzhou	
Zaanstad	
Zabol	
Zabrze	
Zacatecas	
Zagazig	
Zagreb	
Zahedan	
Zama	
Zamboanga City	
Zamora de Hidalgo	
Zanjan	
Zanzibar City	
Zaoyang	
Zaozhuang	
Zapopan	
Zaporizhia	
Zaragoza	
Zárate	
Zaria	
Zarqa	
Zelenodolsk	
Zelenograd	
Zenica	
Zhalantun	
Zhangjiagang	
Zhangjiajie	
Zhangjiakou	
Zhangshu	
Zhangye	
Zhangzhou	
Zhanjiang	
Zhaodong	
Zhaoqing	
Zhaotong	
Zheleznodorozhny	
Zhengzhou	
Zhenjiang	
Zhongshan	
Zhoukou	
Zhoushan	
Zhucheng	
Zhuhai	
Zhuji	
Zhukovsky	
Zhumadian	
Zhuozhou	
Zhuzhou	
Zhytomyr	
Zibo	
Zielona Góra	
Zigong	
Ziguinchor	
Zinder	
Zixing	
Zlatoust	
Zoetermeer	
Zrenjanin	
Zunyi	
Zuwara	
Zürich	
Zwickau	
Zwolle	

